##########
#@#...#..#
#.#.#.#..#
#.#.#.#..#
#.#.#.#..#
#.#.#.#..#
#.#.#.#..#
#.#.#.#..#
#...#....#
##########